1111111111111111
100000C0C0000001
10000000C1C00001
100C100000C00001
1C00100001100001
100010000E000001
10000C0000P00C01
1111111111111111
