1111111111111111
100000C0C0000001
10000000C1C00001
100C100000000001
1C00100001100001
100010000E000001
10000C0000000CP1
1111111111111111
