1111111111111111111111111
1000000000000000000000001
10000000C00C0000000000001
1000000000000000000000001
10000000000C0000000000001
1000000000000000000000001
1000001000000000000000001
1000001000000000000000001
100000100000E000000000001
1000000000000000000000001
10000000000000000000000P1
1111111111111111111111111
