11111111111111111111111111111111111111111
11110000000000000000000011000000110011111
1111110000011110000000C110000000000001111
11000000001100000000111100000000110001111
10000000C11100000000000000000111110000011
10011111111100000111111000001110011100011
11000000001110000000111111000000001110011
11100000111100000000000011000110000110001
1P0000000011C0000111110C11000110000011001
111110001111111001100001111111110011111E1
11111111111111111111111111111111111111111