111111111111111111111111111111111111111111111111
1PCCCCCCCCCCCCCCCC1CCCCCCCCCCCCCCCCCCCCCCCCCCCC1
1C11C1111111C11111111111C1111111C11C111111C111C1
1CCCC1111111CCCCCCCCCCCCC1111111C11CCCCCCCCCCCC1
1111C11CCCCCC11111C11111C11CCCCCC11C111111C11111
1111C11C1111C11111C11111C11C1111C11C110011C11111
1111C11CCC11C11C11C11C11C11CCC11C11C111111C11111
1111C1111111C11111C11111C1111111C11C11CCCCC11111
1111C1111111C11111C11111C1111111C11C111111C11111
1CCCCCCCCCCCCCCCCCCCCCCCCCCCCCCCCCCCCCCCCCCCCCC1
1C11C11111111C1C11111111CCC111CCC111111111C111C1
1CCCCCCCCCCCCC1CCCCCCCCCC1CCCCC1CCCCCCCCCCCCCCE1
111111111111111111111111111111111111111111111111
