111111111111111111111111111111111111111
1C0C1C0C1C0C1C0C1C0C1C0C1C0C1C0C1C0C1E1
1C1C1C1C1C1C1C1C1C1C1C1C1C1C1C1C1C1C1C1
1C1C1C1C1C1C1C1C1C1C1C1C1C1C1C1C1C1C1C1
1C1C1C1C1C1C1C1C1C1C1C1C1C1C1C1C1C1C1C1
1C1C1C1C1C1C1C1C1C1C1C1C1C1C1C1C1C1C1C1
1C1C1C1C1C1C1C1C1C1C1C1C1C1C1C1C1C1C1C1
1C1C1C1C1C1C1C1C1C1C1C1C1C1C1C1C1C1C1C1
1C1C1C1C1C1C1C1C1C1C1C1C1C1C1C1C1C1C1C1
1C1C1C1C1C1C1C1C1C1C1C1C1C1C1C1C1C1C1C1
1C1C1C1C1C1C1C1C1C1C1C1C1C1C1C1C1C1C1C1
1C1C1C1C1C1C1C1C1C1C1C1C1C1C1C1C1C1C1C1
1C1C1C1C1C1C1C1C1C1C1C1C1C1C1C1C1C1C1C1
1C1C1C1C1C1C1C1C1C1C1C1C1C1C1C1C1C1C1C1
1C1C1C1C1C1C1C1C1C1C1C1C1C1C1C1C1C1C1C1
1C1C1C1C1C1C1C1C1C1C1C1C1C1C1C1C1C1C1C1
1C1C1C1C1C1C1C1C1C1C1C1C1C1C1C1C1C1C1C1
1C1C1C1C1C1C1C1C1C1C1C1C1C1C1C1C1C1C1C1
1C1C1C1C1C1C1C1C1C1C1C1C1C1C1C1C1C1C1C1
1C1C1C1C1C1C1C1C1C1C1C1C1C1C1C1C1C1C1C1
1C1C1C1C1C1C1C1C1C1C1C1C1C1C1C1C1C1C1C1
1P1C0C1C0C1C0C1C0C1C0C1C0C1C0C1C0C1C0C1
111111111111111111111111111111111111111
